11 11
WWWWWWWWWWW
WFFFFFFFFHW
WFFFFFFFFFW
WFFFFFFFFFW
WFFFFFFFFFW
WFFFFFFFFFW
WFFFFFFFFFW
WFFFFFFFFFW
WFFFFFFFFFW
WEFFFFFFFUW
WWWWWWWWWWW