30 120
WWWWWWWWWWWWWWWWWWWWWWWWWWWWWWWWWWWWWWWWWWWWWWWWWWWWWWWWWWWWWWWWWWWWWWWWWWWWWWWWWWWWWWWWWWWWWWWWWWWWWWWWWWWWWWWWWWWWWWWW
WGGGGGGGGGGGGGGGGGGGGGGGGGGGGGGGGGGGGGGGGGGGGGGGGGGGGGGGGGGGGGGGGGGGGGGGGGGGGGGGGGGGGGGGGGGGGGGGGGGGGGGGGGGGGGGGGGGGGGGW
WGGGGGGGGGGGGGGGGGGGGGGGGGGGGGGGGGGGGGGGGGGGGGGGGGGGGGGGGGGGGGGGGGGGGGGGGGGGGGGGGGGGGGGGGGGGGGGGGGGGGGC    GGGGGGGGGGGGW
WGGGGGGGGGGGGGGGGGGGGGGGGGGGGGGGGGGGGGGGGGGGGGGGGGGGGGGGGGGGGGGGGGGGGGGGGGGGGGGGGGGGGGGGGGGGGGGGGGGGGG     GGGGGGGGGGGGW
WGGGGGGGGGGGGGGGGGGGGGGGGGGGGGGGGGGGGGGGGGGGGGGGGGGGGGGGGGGGGGGGGGGGGGGGGGGGGGGGGGGGGGGGGGGGGGGGGGGGGG     GGGGGGGGGGGGW
WGGG4   GGGGGGG6  GGGGGGGGGGGGGGGGGGGGGGGGGGGGGGGGGGGGGGGGGGGGGGGGGGGGGGGGGGGGGGGGGGGGGGGGGGGGGGGGGGGG     GGGGGGGGGGGGW
WGGG    GGGGGGG   GGGGGGGGGGGGGGGGGGGGGGGGGGGGGGGGGGGGGGGGGGGGGGGGGGGGGGGGGGGGGGGGGGGGGGGGGGGGGGGGGGGGGGLGGGGGGGGGGGGGGW
WGGG    GGGGGGG   GGGGG5     GGGGGGGGGGGGGGGGGGGGGGGGGGGGGGGGGGGGGGGGGGGGGGGGGGGGGGGGGGGGGGGGGPPPPPPPPPPPPPPPGGGGGGGGGGW
WPPPPPPPPGGGGGGGGGGGGGG      GGTGGG6  GGGGGGGGGGGGGGGGGGGGGGGGGGGGGGGGG5     GGGGGGGGGGGGGGPPPPPPPPPPPPPPPPPPPPPPPPPGGGW
WPPPPPPPPPPPPPPPGGGGGGG      GGGGGG   GGG6  GGG6  GGG5     GGGG6  GGGGG      GGGGGGGGGGGGGPPPPPPPPPPPPPPPPPPPPPGGGGGGGGW
WPPPPPPPPPPPPPPPPPPPPPGGGGGGGGGGGGG   GGG   GGG   GGG      GGGG   GGGTG      GG1   GGGGGPPPPPPPPPPPGGGGGGGGGGGGGGGGGGGGW
WGGPPPPPPPPPPPPPPPPPPPPPPPPPGGGGGGGGGGGGG   GGG   GGG      GGGG   GGGGGGGGGGGGG    GPPPPPPPPPPPPPGGGGGGGGGGGGGGGGGGGGGGW
WGGGG3   PPPGGGGPPPPPPPPPPPPPPPPPPGGGGGGGGGGGGGGGGGGGGGGGGGGGGGGGGGGGGGGGGGGGGG    PPPPPPPGGGGGGGGGGGGGGGGGGGGGGGGGGGGGW
WGGGG    PPPGGGGGGGGGPPPPPPPPPPPPPPPPPPPPPPPPPPPPPPPPPPPPPPPPPPPPPPPPPPPPPPPPPPPPPPPPPPPGGGGGGGGGGGGGGGGGGGGGGGGGGGGGGGW
WGGGG    PPPGGGGGGGGGGGGGGGGPPPPPPPPPPPPPPPPPPPPPPPPPPPPPPPPPPPPPPPPPPPPPPPPPPPPPPPPPGGGGGGGGGGGGGGGGGGGGGGGGGGGGGGGGGGW
WGGGGGGGGPPPGGGGGGGGGGGGGGGGGGGGGPPPPPPPPPPPPPPPPPPPPPPPPPPPPPPPPPPPPPPPPPPPPPPPPPPPPPPPGGGGGGGGGGGGGGGGGGGGGGGGGGGGGGGW
WGGGGGGGGPPPGGGGGGGGGGGGGGGGGGGGGGGGGGGGGGGGGGGGGGGGGGGGGGGGGGGGGGGGGGGGGGGGGGGG2   PPPPPPPGGGGGGGGGGGGGGGGGGGGGGGGGGGGW
WGGGGGGGGPPPGGGGGGGGGGGGGGGGGGGGGGGTGGGGGGGGGGGGGGGGGGGGGGGTGGGGGGGGGGGGGGGGGGGG    PPPPPPPPPPPPPGGGGGGGGGC    GGGGGGGGW
WGGGGGGGGPPPGGGGGGGGGGGGGGGGGGGGGGGGGGGGGGGGGGGGGGGGGGGGGGGGGGGGGGGGGGGGGGGGGGGG    GGPPPPPPPPPPPGGGGGGGGG     GGGGGGGGW
WGGGGGGGGPPPPGGGGGGGTGGGGH      GGGGGGGGGGGGGGGGGGGGGGGGGGGGGGGGGGGGGGGGGGGGGGGGGGGGGGGPPPPPPPPPPPGGGGGGGG     GGGGGGGGW
WGGGGGGGGGPPPPGGGGGGGGGGG       GGGGGGGGGGGGGGGGGGGGGGGGGGGGGGGGGGGGGGGGGGGGGGGGGGGGGGGGGGPPPPPPPPPPPGGGGG     GGGGGGGGW
WGGTGGGGGGGPPPPGGGGGGGGGG       GGGGGGGGGGGGTGGGGGGGGGGGGGGGGGGGGGGGGGGGGGGGGGGGGGGGGGGGGGGPPPPPPPPPPPGGGGGGLGGGGGGGGGGW
WGGGGGGGGGGGPPPPGGGGGGGGG       GGGGGGGGGGGGGGGGGGGGGGGGGGGGGGGGGGGGGGGGGGGGGGGGGGGGGGGGGGGGPPPPPPPPPPPPPPPPPPPGGGGGGGGW
WGGGGGGGGGGGGPPPPGGGGGGGG       GGGGGGGGGGGGGGGGGGGGGGGGGGGGGGGGGGGGGGGGGGGGGGGGGGGGGGGGGGGGGGPPPPPPPPPPPPPPPPPPPPPPGGGW
WGGGGGGGGGGGGGPPPPGGGGGGG       GGGGGGGGGGGGGGGGGGGGGGGGGGGGGGGGGGGGGGGGGGGGGGGGGGGGGGGGGGGGGGGGPPPPPPPPPPPPPPPGGGGGGGGW
WGGGGGGGGGGGGGGPPPPGGGGGGR  DR  GGGGGGGGGGGGGGGGGGGGGGGGGGGGGGGGGGGGGGGGGGGGGGGGGGGGGGGGGGGGGGGGGGGGGGGGGGGGGGGGGGGGGGGW
WGGGGGGGGGGGGGGGPPPPPPPPPPPPPPPPPPPPPPPGGGGGGGGTGGGGGGGGGGGGGGGGGGGGGGGGGGGGGGGGGGGGGGGGGGGGGGGGGGGGGGGGGGGGGGGGGGGGTGGW
WGGGGGGGGGGGGGGGGPPPPPPPPPPPPPPPPPPPPPPGGGGGGGGGGGGGGGGGGGGGGGGGGGGGGGGGGGGGGGGGGGGGGGGGGGGGGGGGGGGGGGGGGGGGGGGGGGGGGGGW
WGGGGGGGGGGGGGGGGGPPPPPPPPPPPPPPPPPPPPPGGGGGGGGGGGGGGGGGGGGGGGGGGGGGGGGGGGGGGGGGGGGGGGGGGGGGGGGGGGGGGGGGGGGGGGGGGGGGGGGW
WWWWWWWWWWWWWWWWWWWWWWWWWWWWWWWWWWWWWWWWWWWWWWWWWWWWWWWWWWWWWWWWWWWWWWWWWWWWWWWWWWWWWWWWWWWWWWWWWWWWWWWWWWWWWWWWWWWWWWWW