20 90
EEEEEEEEEEEEEEEEEEEEEEEEEEEEEEEEEEEEEEEEEEEEEEEEEEEEEEEEEEEEEEEEEEEEEEEEEEEEEEEEEEEEEEEEEE
EEEEEEEEEEEEEEEEEEEEEEEEEEEEEEEEEEEEEEEEEEEEEEEEEEEEWWWWWWWWWWWWWWWWWWWWEEEEEEEEEEEEEEEEEE
EEEEEEEEEEEEEEEEEEEEEEEEEEEEEEEEEEEEEEEEEEEEEEEEEEEEWGGGGGGGGGGGGGGGGGGWEEEEEEEEEEEEEEEEEE
EEWWWWWWWWWWWWWWWWWWWWEEEEEWWWWWWWWWWWWWWWWWWWWEEEEEWGGGGGGGGGGGGGGGGGGWEEEEEEEEEEEEEEEEEE
EEWGGGGGGGGGGGGGGGGGGWEEEEEWGGGGGGGGGGGGGGGGGGWEEEEEWGGGGGGGGGGGGGGGGGGWEEEEEEEEEEEEEEEEEE
EEWGGGGGGGGGGGGGGGGGGWEEEEEWGGGGGGGGGGGGGGGGGGWEEEEEWGGGGGGGGGGGGGGGGGGWEEEEEEEEEEEEEEEEEE
WWWGGGGGGGGGGGGGGGGGGWWWWWWWGGGGGGGGGGGGGGGGGGWWWWWWWGGGGGGGGGGGGGGGGGGWWWWWWWWWWWWEEEEEEE
WGGGGGGGGGGGGGGGGGGGGGGGGGGGGGGGGGGGGGGGGGGGGGGGGGGGGGGGGGGGGGGGGGGGGGGGGGGGGGGGGGWEEEEEEE
WGGGGGGGGGGGGGGGGGGGGGGGGGGGGGGGGGGGGGGGGGGGGGGGGGGGGGGGGGGGGGGGGGGGGGGGGGGGGGGGGGWEEEEEEE
WGGGGGGGGGGGGGGGGGGGGGGGGGGGGGGGGGGGGGGGGGGGGGGGGGGGGGGGGGGGGGGGGGGGGGGGGGGGGGGGGGWEEEEEEE
WWWGGGGGGGGGGGGGGGGGGWWWWWWWGGGGGGGGGGGGGGGGGGWWWWWWWGGGGGGGGGGGGGGGGGGWWWWWWWWWWWWEEEEEEE
EEWGGGGGGGGGGGGGGGGGGWEEEEEWGGGGGGGGGGGGGGGGGGWEEEEEWGGGGGGGGGGGGGGGGGGWEEEEEEEEEEEEEEEEEE
EEWGGGGGGGGGGGGGGGGGGWEEEEEWGGGGGGGGGGGGGGGGGGWEEEEEWGGGGGGGGGGGGGGGGGGWEEEEEEEEEEEEEEEEEE
EEWWWWWWWWWWWWWWWWWWWWEEEEEWWWWWWWWWWWWWWWWWWWWEEEEEWGGGGGGGGGGGGGGGGGGWEEEEEEEEEEEEEEEEEE
EEEEEEEEEEEEEEEEEEEEEEEEEEEEEEEEEEEEEEEEEEEEEEEEEEEEWGGGGGGGGGGGGGGGGGGWEEEEEEEEEEEEEEEEEE
EEEEEEEEEEEEEEEEEEEEEEEEEEEEEEEEEEEEEEEEEEEEEEEEEEEEWGGGGGGGGGGGGGGGGGGWEEEEEEEEEEEEEEEEEE
EEEEEEEEEEEEEEEEEEEEEEEEEEEEEEEEEEEEEEEEEEEEEEEEEEEEWWWWWWWWWWWWWWWWWWWWEEEEEEEEEEEEEEEEEE
EEEEEEEEEEEEEEEEEEEEEEEEEEEEEEEEEEEEEEEEEEEEEEEEEEEEEEEEEEEEEEEEEEEEEEEEEEEEEEEEEEEEEEEEEE
EEEEEEEEEEEEEEEEEEEEEEEEEEEEEEEEEEEEEEEEEEEEEEEEEEEEEEEEEEEEEEEEEEEEEEEEEEEEEEEEEEEEEEEEEE
EEEEEEEEEEEEEEEEEEEEEEEEEEEEEEEEEEEEEEEEEEEEEEEEEEEEEEEEEEEEEEEEEEEEEEEEEEEEEEEEEEEEEEEEEE