20 60
EEEEEEEEEEEEEEEEEEEEEEEEEEEEEEEEEEEEEEEEEEEEEEEEEEEEEEEEEEEE
EWWWWWWWWWWWWWWWWWWEEEEEEEEEEEEEEEEEEEEEEEEEEEEEEEEEEEEEEEEE
EWGGGGGGGGGGGGGGGGWEEEEEEEEEEEEEEEEEEEEEEEEEEEEEEEEEEEEEEEEE
EWGGGGGGGGGGGGGGGGWEEEEEEEEEEEEEEEEEEEEEEEEEEEEEEEEEEEEEEEEE
EWGWWGGWWWGWWWWWWWWEEEEEEEEEEEEEEEEEEEEEEEEEEEEEEEEEEEEEEEEE
EWGGGGGGGGGGGGGGGGWEEEEEEEEEEEEEEEEEEEEEEEEEEEEEEEEEEEEEEEEE
WWGGGGGGGGGGGGGGGGWWWWWWWWWWWWWWWWWWWWWWWWWWWWWWWWWWWWWWWWWW
WGGGGGGGGGGGGGGGGGWGGGGGGGGGGGGGGGGGGGGGGGGGGGGGGGGGGGGGGGGW
WGGGGGGGGGGGGGGGGGWGGGGGGGGGGGGGGGGGGGGGGGGGGGGGGGGGGGGGGGGW
WGGGGGGGGGGGGGGGGGWGGGGGGGGGGGGGGGGGGGGGGGGGGGGGGGGGGGGGGGGW
WWGGGGGGGGGGGGGGGGWWWWWWWWWWWWWWWWWWWWWWWWWWWWWWWWWWWWWWWWWW
EWGGGGGGGGGGGGGGGGWEEEEEEEEEEEEEEEEEEEEEEEEEEEEEEEEEEEEEEEEE
EWGGGGGGGGGGGGGGGGWEEEEEEEEEEEEEEEEEEEEEEEEEEEEEEEEEEEEEEEEE
EWGGGGGGGGGGGGGGGGWEEEEEEEEEEEEEEEEEEEEEEEEEEEEEEEEEEEEEEEEE
EWGWWGGWWWGWWWWWWWWEEEEEEEEEEEEEEEEEEEEEEEEEEEEEEEEEEEEEEEEE
EWGGGGGGGGGGGGGGGGWEEEEEEEEEEEEEEEEEEEEEEEEEEEEEEEEEEEEEEEEE
EWGGGGGGGGGGGGGGGGWEEEEEEEEEEEEEEEEEEEEEEEEEEEEEEEEEEEEEEEEE
EWGGGGGGGGGGGGGGGGWEEEEEEEEEEEEEEEEEEEEEEEEEEEEEEEEEEEEEEEEE
EWWWWWWWWWWWWWWWWWWEEEEEEEEEEEEEEEEEEEEEEEEEEEEEEEEEEEEEEEEE
EEEEEEEEEEEEEEEEEEEEEEEEEEEEEEEEEEEEEEEEEEEEEEEEEEEEEEEEEEEE