20 50
EEEEEEEEEEEEEEEEEEEEEEEEEEEEEEEEEEEEEEEEEEEEEEEEEE
EWWWWWWWWWWWWWWWWWWWWWWWEEWWWWWWWWWWWWWWWWWWWWWWWW
EWGGGGGGGGGGGGGGGGGGGGGWEEWGGGGGGGGGGGGGGGGGGGGGGW
EWGGGGGGGGGGGGGGGGGGGGGWEEWGGGGGGGGGGGGGGGGGGGGGGW
EWGGGGGGGGGGGGGGGGGGGGGWEEWGGGGGGGGGGGGGGGGGGGGGGW
EWGGGGGGGGGGGGGGGGGGGGGWEEWGGGGGGGGGGGGGGGGGGGGGGW
WWGGGGGGGGGGGGGGGGGGGGGWWWWGGGGGGGGGGGGGGGGGGGGGGW
WGGGGGGGGGGGGGGGGGGGGGGWGGGGGGGGGGGGGGGGGGGGGGGGGW
WGGGGGGGGGGGGGGGGGGGGGGWGGGGGGGGGGGGGGGGGGGGGGGGGW
WGGGGGGGGGGGGGGGGGGGGGGWGGGGGGGGGGGGGGGGGGGGGGGGGW
WWGGGGGGGGGGGGGGGGGGGGGWWWWGGGGGGGGGGGGGGGGGGGGGGW
EWGGGGGGGGGGGGGGGGGGGGGWEEWGGGGGGGGGGGGGGGGGGGGGGW
EWGGGGGGGGGGGGGGGGGGGGGWEEWGGGGGGGGGGGGGGGGGGGGGGW
EWGGGGGGGGGGGGGGGGGGGGGWEEWGGGGGGGGGGGGGGGGGGGGGGW
EWGGGGGGGGGGGGGGGGGGGGGWEEWGGGGGGGGGGGGGGGGGGGGGGW
EWGGGGGGGGGGGGGGGGGGGGGWEEWGGGGGGGGGGGGGGGGGGGGGGW
EWGGGGGGGGGGGGGGGGGGGGGWEEWGGGGGGGGGGGGGGGGGGGGGGW
EWWWWWWWWWWWWWWWWWWWWWWWEEWGGGGGGGGGGGGGGGGGGGGGGW
EEEEEEEEEEEEEEEEEEEEEEEEEEWWWWWWWWWWWWWWWWWWWWWWWW
EEEEEEEEEEEEEEEEEEEEEEEEEEEEEEEEEEEEEEEEEEEEEEEEEE