50 50
EEEEEEEEEEEEEEEEEEEEEWWWWWEEEEEEEEEEEEEEEEEEEEEEEE
EEEEEEEEEEEEEEEEEEEEEWGGGWEEEEEEEEEEEEEEEEEEEEEEEE
EEEEEEEEEEEEEEEEEEEEEWWGWWEEEEEEEEEEEEEEEEEEEEEEEE
EEEEEEEEEEEEEEEEEEEEEEWGWEEEEEEEEEEEEEEEEWWWEEEEEE
EEEEEEEEEEEEEEEEEEEEEEWGWEEEEEEEEEEEEEEEEWGWEEEEEE
EEEEEEEEEEEEEEEEEEEEEEWGWEEEEEEEEEEEEEEEEWGWEEEEEE
EEEEEEEEEEEEEEEEEEEEEEWGWEEEEEEEWWWEEEEEEWGWEWWWEE
EEEEEEEEEEEEEEEEEEEEEEWGWEEEEEEEWGWEEEEEEWGWEWGWEE
EEEEEEEEEEEEEEEEEEEEEEWGWEEEEEEEWGWEEEEEEWGWEWGWEE
WWWWWWWWWWWWWWWWWWWWWWWGWEEEEEEEWGWEEEEEEWGWEWGWEE
WGGGGGGGGGGGGGGGGGGGGGGGWEEEEEEEWGWEEEEEEWGWEWGWEE
WWWWWWWGWWWWWWWWWWWWWWWWWEEEEEEEWGWWWWWWWWGWEWGWEE
EEEEEEWGWEEEEEEEEEEEEEEEEEEEEEEEWGGGGGGGGGGWEWGWEE
EEEEEEWGWEEEEEEEEEEWWWEEEEEEEEEEWGWWWWWWWWGWEWGWEE
EEEEEEWGWEEEEEEEEEEWGWEEEEEEEEEEWGWWWWWWWWGWWWGWEE
EEEEEEWGWEEEEEEEEEEWGWEEEEEEEEEEWGWGGGGGGGGGWWGWEE
EEEEEEWGWEEEEEEEEEEWGWEEEEEEEEEEWGWWWWWWWWGWWWGWEE
EEEEEEWGWEEEEEEEEEEWGWEEEEEEEEEEWGWWWWWWWWWWWWGWWW
EEEEEEWGWEEEEEEEEEEWGWWWWWWWWWWWWGGGGGGGGGGGGGGGGW
EEEEEEWGWEEEEEEEEEEWGGGGGGGGGGGGGGWWWWWWWWWWWWWWWW
EEEEEEWGWEEEEEEEEEEWGWWWWWWWWWWWWGWEEEEEEEEEEEEEEE
EEEEEEWGWEEEEEEEEEEWGWEEEEEEEEEEWGWEEEEEEEEEEEEEEE
EEEEEEWGWEEEEEEEEEEWGWEEEEEEEEEEWGWEEEEEEEEEEEEEEE
EEEEEEWGWEEEEEEEEEEWGWEEEEEEEEEEWGWEEEEEEEEEEEEEEE
EEEEEEWGWEEEEEEEEEEWGWEEEEEEEEEEWGWEEEEEEEEEEEEEEE
EEEEEEWGWEEEEEEEEEEWGWEEWWWWWWWWWGWEEEEEEEEEEEEEEE
EEEEEEWGWEEEEEEEEEEWGWEEWGGGGGGGGGWEEEEEEEEEEEEEEE
EEEEEEWGWEEEEEEEEEEWGWEEWWWWWWWWWGWEEEEEEEEEEEEEEE
EEEEEEWGWEEEEEEEEEEWGWEEEEEEEEEEWGWEEEEEEEEEEEEEEE
EEEEEEWGWEEEEEEEEEEWGWEEEEEEEEEEWGWEEEEEEEEEEEEEEE
EEEEEEWGWEEEEEEEEEEWGWEEEEEEEEEEWGWEEEEEEEEEEEEEEE
EEEEEEWGWEEEEEEEEEEWGWEEEEEEEEEEWGWEEEEEEEEEEEEEEE
EEEEEEWGWEEEEEEEEEEWGWEEEEEEEEEEWGWEEEEEEEEEEEEEEE
EEEEEEWGWEEEEEEEEEEWGWEEEEEEEEEEWGWEEWWWEEEEEEEEEE
EEEEEEWGWEEEEEEEEEEWGWEEEEEEEEEEWGWEEWGWEEEEEEEEEE
EEEEEEWGWEEEEEEEEEEWGWEEEEEEEEEEWGWEEWGWEEEEEEEEEE
EEEEEEWGWEEEEEEEEEEWGWEEEEEEEEEEWGWEEWGWEEEEEEEEEE
EEEEEEWGWEEEEEEEEEEWGWEEEEEEEEEEWGWEEWGWEEEEEEEEEE
EEEWWWWGWWWWWEEEEEEWGWEEEEEEEEEEWGWEEWGWEEEEEEEEEE
EEEWGGGGGGGGWEEEEEEWGWEEEEEEEEEEWGWEEWGWEEEEEEEEEE
EEEWWWWWWWGWWEEEEEEWGWEEEEEEEEEEWWWEEWGWEEEEEEEEEE
EEEEEEEEEWGWEEEEEEEWGWEEEEEEEEEEEEEEEWGWEEEEEEEEEE
EEEEEEEEEWGWWWWWWWWWGWEEEEEEEEEEEEEEEWGWEEEEEEEEEE
EEEEEEEEEWGGGGGGGGGGGWEEEEEEEEEEEEEEEWGWEEEEEEEEEE
EEEEEEEEEWGWWWWWWWWWGWWWWWWWWWWWWWWWWWGWWWWEEEEEEE
EEEEEEEEEWGWEEEEEEEWGGGGGGGGGGGGGGGGGGGGGGWEEEEEEE
EEEEEEEEEWGWEEEEEEEWGWWWWWWWWWWWWWWWWWWWWWWEEEEEEE
EEEEEEEEEWWWEEEEEEWWGWWEEEEEEEEEEEEEEEEEEEEEEEEEEE
EEEEEEEEEEEEEEEEEEWGGGWEEEEEEEEEEEEEEEEEEEEEEEEEEE
EEEEEEEEEEEEEEEEEEWWWWWEEEEEEEEEEEEEEEEEEEEEEEEEEE