20 90
EEEEEEEEEEEEEEEEEEEEEEEEEEEEEEEEEEEEEEEEEEEEEEEEEEEEEEEEEEEEEEEEEEEEEEEEEEEEEEEEEEEEEEEEEE
EEEEEEEEEEEEEEEEEEEEEEEEEEEEEEEEEEEEEEEEEEEEEEEEEEEEWWWWWWWWWWWWWWWWWWWWEEEEEEEEEEEEEEEEEE
EEEEEEEEEEEEEEEEEEEEEEEEEEEEEEEEEEEEEEEEEEEEEEEEEEEEWGGGGGGGGGGGGGGGGGGWEEEEEEEEEEEEEEEEEE
EEWWWWWWWWWWWWWWWWWWWWEEEEEWWWWWWWWWWWWWWWWWWWWEEEEEWGGGGWGGGGGGGGGWGGGWEEEEEEEEEEEEEEEEEE
EEWGGGGGGGGGGGGGGGGGGWEEEEEWGGGGGGGGGGGGGGGGGGWEEEEEWGGGGWGGGGGGGGGWGGGWEEEEEEEEEEEEEEEEEE
EEWGGGGWGGGGGGGGGGGGGWEEEEEWGGGGGGGWGGGGGGGGGGWEEEEEWGGGGGGGGGGGGGGGGGGWEEEEEEEEEEEEEEEEEE
WWWGGGGWGGGGGGGGGGGGGWWWWWWWGGGGGGGGGGGGGGGGGGWWWWWWWGGGGGGGGGGWGWGWGGGWEEEEEEEEEEEEEEEEEE
WGGGGGGGGGGGGGGGGGGGGWGGGGGGGGGGGGGWGGGGGGGGGGWGGGGGGGGGGGGGGGGGGGGGGWGWEEEEEEEEEEEEEEEEEE
WGGGGGGWGWWGWWGWWGGGGWGGGGGGGGGWGWWGGGWWWGGGGGWGGGGGGGGGGGGGGGGGGGGGGWGWEEEEEEEEEEEEEEEEEE
WGGGGGGGGGGGGGGGGGGGGWGGGGGGGGGGGGGGWGGGGGGGGGWGGGGGGGGGGGGGGGGGGGGGGWGWEEEEEEEEEEEEEEEEEE
WWWGGGGWGGGGGGGGGGGGGWWWWWWWGGGGGGGGGGGGGGGGGGWWWWWWWGGGWGWGWWGWGWGGGWGWEEEEEEEEEEEEEEEEEE
EEWGGGGWGGGGGGGGGGGGGWEEEEEWGGGGGGGGWGGGGGGGGGWEEEEEWGGGGGGGGGGGGGGWGGGWEEEEEEEEEEEEEEEEEE
EEWGGGGGGGGGGGGGGGGGGWEEEEEWGGGGGGGGGGGGGGGGGGWEEEEEWGGGGGGGGGGGGGGGGGGWEEEEEEEEEEEEEEEEEE
EEWWWWWWWWWWWWWWWWWWWWEEEEEWWWWWWWWWWWWWWWWWWWWEEEEEWGGGGGGGGGGGGGGWGGGWEEEEEEEEEEEEEEEEEE
EEEEEEEEEEEEEEEEEEEEEEEEEEEEEEEEEEEEEEEEEEEEEEEEEEEEWGGGGGGGGGGGGGGWGGGWEEEEEEEEEEEEEEEEEE
EEEEEEEEEEEEEEEEEEEEEEEEEEEEEEEEEEEEEEEEEEEEEEEEEEEEWGGGGGGGGGGGGGGGGGGWEEEEEEEEEEEEEEEEEE
EEEEEEEEEEEEEEEEEEEEEEEEEEEEEEEEEEEEEEEEEEEEEEEEEEEEWWWWWWWWWWWWWWWWWWWWEEEEEEEEEEEEEEEEEE
EEEEEEEEEEEEEEEEEEEEEEEEEEEEEEEEEEEEEEEEEEEEEEEEEEEEEEEEEEEEEEEEEEEEEEEEEEEEEEEEEEEEEEEEEE
EEEEEEEEEEEEEEEEEEEEEEEEEEEEEEEEEEEEEEEEEEEEEEEEEEEEEEEEEEEEEEEEEEEEEEEEEEEEEEEEEEEEEEEEEE
EEEEEEEEEEEEEEEEEEEEEEEEEEEEEEEEEEEEEEEEEEEEEEEEEEEEEEEEEEEEEEEEEEEEEEEEEEEEEEEEEEEEEEEEEE