20 50
EEEEEEEEEEEEEEEEEEEEEEEEEEEEEEEEEEEEEEEEEEEEEEEEEE
EWWWWWWWWWWWWWWWWWWWWWWWEEwWWWWWWWWWWWWWWWWWWWWWWW
EWGGGGGGGGGGLGGGGGGLGGGWEEWGGLLLLLLLLLLLLLLLLLLGGW
EWGGGLGGGGGGGGGGLGGGGGGWEEWGGGGGGGGGGGGGGGGGGGGGGW
EWGGGLGGGGGGGGGGLGGGGGGWEEWGGGGGGGGGGGGGGGGGGGGGGW
EWGGGGGGGGGGLGGGGGGLGGGWEEWGGLLLLLLLLLLLLLLLLLLGGW
WWGGGGGGGGGGGGGGGGGGGGGWWWWGGGGGGGGGGGGGGGGGGGGGGW
WGGGGGGGGGLGGGGLGGGGGGGWGGGGGGGGGGGGGGGGGGGGGGGGGW
WGGGGGGGLGGGGGGGGGLGGGGWGGGGGLLLLLLLLLLLLLLLLLLGGW
WGGGGGGGGGLGGGGLGGGGGGGWGGGGGGGGGGGGGGGGGGGGGGGGGW
WWLGGGGLGGGGGGGGGGGGGGGWWWWGGGGGGGGGGGGGGGGGGGGGGW
EWGGGGGGGGGGGLGGGGGGGGGWEEWGGLLLLLLLLLLLLLLLLLLGGW
EWGGGGGLGGGGGLGGGGGGGGGWEEWGGGGGGGGGGGGGGGGGGGGGGW
EWGGGGGLGGGGGLGGGGGGGGGWEEWGGGGGGGGGGGGGGGGGGGGGGW
EWGGGGGGGGGGGGGGGGGLGGGWEEWGGLLLLLLLLLLLLLLLLLLGGW
EWGGGGGLGGGGGLGGGGGGGGGWEEWGGGGGGGGGGGGGGGGGGGGGGW
EWGGGGGLGGGGGLGGGGGGGGGWEEWGGGGGGGGGGGGGGGGGGGGGGW
EWWWWWWWWWWWWWWWWWWWWWWWEEWGGLLLLLLLLLLLLLLLLLLGGW
EEEEEEEEEEEEEEEEEEEEEEEEEEwwwwwwwwwwwwwwwwwwwwwwww
EEEEEEEEEEEEEEEEEEEEEEEEEEEEEEEEEEEEEEEEEEEEEEEEEE